11111411111111111111111111111111
10101300000000000000000000000001
10000300000000000000000000000001
10000300000000000100000000000001
10000300000000000000000000000001
10000333331000000100000000000001
10000000030000000000000000000001
10000000030000000000000010000001
10000333330000000000000000000001
10000300000000000000000000000001
10000300000100000000000000000001
10000300000000000000000000000001
10000333333333333333000000000001
10000000000000001003000000000001
10000000000000000003000000000001
10000000000000000003333333333333
10000000000000001000000000000001
11111111111111111111111111111111